Mimiga Town.mp3
18,12,,,,,,,,,,,,,,,,,,,,,,,,,,,,,,,,,,,,,,
23,23,23,23,23,23,23,23,23,23,23,23,23,23,23,23,23,23
42,23,42,23,42,23,42,23,42,23,42,23,42,23,42,23,42,23
9,9,9,9,9,9,9,9,9,9,9,9,9,9,9,9,9,9
23,23,23,41,23,23,41,23,23,23,23,23,23,23,23,23,23,23
40,40,40,40,40,40,40,40,40,40,40,40,40,40,40,40,40,40
23,23,23,23,23,23,23,23,23,23,23,23,23,23,23,23,23,23
40,40,40,40,40,40,40,40,40,40,40,40,40,40,40,40,40,40
23,23,23,23,23,23,23,23,23,23,23,23,23,23,23,23,23,23
23,23,23,23,23,23,23,23,23,23,23,23,23,23,23,23,23,23
23,23,23,23,23,23,23,23,23,23,23,23,23,23,23,23,23,23
23,23,23,23,23,23,23,23,23,23,23,23,23,23,23,23,23,23
23,23,23,23,23,23,23,23,23,23,23,23,23,23,23,23,23,23
23,23,23,23,23,23,23,23,23,23,23,23,23,23,23,23,23,23