Mimiga Town.mp3
18,13,,,,,,,,,,,,,,,,,,,,,,,,,,,,,,,,,,,,,,
23,23,23,23,23,23,23,23,23,23,23,23,23,23,23,23,23,23
42,23,42,23,42,23,42,23,42,23,42,23,42,23,42,23,42,23
9,9,9,9,9,9,9,9,9,9,9,9,9,9,9,9,9,9
41,23,23,41,23,23,41,23,23,41,23,23,41,23,23,41,23,23
40,40,40,40,40,40,40,40,40,40,40,40,40,40,40,40,40,40
41,23,23,41,23,23,41,23,23,41,23,23,41,23,23,41,23,23
40,40,40,40,40,40,40,40,40,40,40,40,40,40,40,40,40,40
41,23,23,41,23,23,41,23,23,41,23,23,41,23,23,41,23,23
23,23,23,23,23,23,23,23,23,23,23,23,23,23,23,23,23,23
23,23,23,23,23,23,23,23,23,23,23,23,29,23,23,23,23,23
23,23,23,23,23,23,23,23,23,23,21,21,29,21,23,23,23,23
23,23,23,23,23,23,23,23,23,23,21,23,23,21,23,23,23,23
23,23,23,23,23,23,23,23,23,23,21,23,23,21,23,23,23,23