OnettTheme.mp3
25,30,,,,,,,,,,,,,,,,
1,1,1,1,1,1,1,1,1,1,1,1,1,1,1,1,1,1,1,1,1,1,1,1,1
1,1,1,1,1,1,1,1,1,1,1,1,1,1,1,1,1,1,1,1,1,1,1,1,1
1,3,0,0,0,0,0,0,0,0,0,0,0,1,1,0,0,0,0,0,0,0,0,1,1
6,0,0,4,0,0,0,0,0,0,1,1,1,0,0,1,0,0,0,0,0,0,0,1,1
1,1,0,0,0,0,0,0,0,1,2,2,2,1,0,0,1,0,0,0,0,0,0,1,1
1,1,0,0,0,0,0,0,1,2,2,2,2,2,1,1,1,1,0,0,0,0,0,1,1
1,1,0,0,0,7,9,0,1,2,2,2,2,2,1,3,3,2,1,0,0,0,0,1,1
1,1,0,0,0,9,8,1,0,2,2,2,2,2,2,1,1,2,1,0,0,0,0,1,1
1,1,0,0,0,0,0,1,0,2,2,0,0,0,0,2,2,0,1,0,0,0,0,1,1
1,1,0,0,0,0,0,1,0,2,0,0,0,1,1,0,1,0,1,0,0,0,0,1,1
1,1,0,0,0,0,0,0,1,2,0,0,0,1,1,0,1,0,1,0,0,0,0,1,1
1,1,0,0,0,0,0,1,1,2,0,0,0,0,0,0,0,0,1,0,0,0,0,1,1
1,1,0,0,0,1,1,0,0,1,2,0,1,1,1,1,0,1,1,1,0,0,0,1,1
1,1,0,0,1,2,0,0,4,0,0,0,0,0,0,0,1,0,0,2,1,0,0,1,1
1,1,0,0,1,2,2,0,0,0,0,1,1,1,1,1,0,0,2,2,1,0,0,1,1
1,1,0,1,2,2,2,0,1,0,0,0,0,0,0,0,0,0,2,2,2,1,0,1,1
1,1,0,1,2,2,1,1,1,0,0,0,0,0,0,0,1,1,1,2,2,1,0,1,1
1,1,0,1,2,2,2,1,1,0,0,0,0,0,0,0,1,1,2,2,2,1,0,1,1
1,1,0,1,2,2,2,1,1,2,2,2,2,2,2,2,1,1,2,2,2,1,0,1,1
1,1,0,0,1,1,1,0,1,2,2,2,2,2,2,2,1,0,1,1,1,0,0,1,1
1,1,0,0,0,0,0,1,0,0,2,2,2,2,0,0,0,1,0,0,0,0,0,1,1
1,1,0,0,0,0,1,2,2,0,0,0,1,0,0,0,0,2,1,0,0,0,0,1,1
1,1,0,0,0,1,1,2,2,2,0,1,0,1,0,2,2,2,1,1,0,0,0,1,1
1,1,0,2,2,2,2,2,2,2,1,0,0,0,1,2,2,2,2,2,2,2,0,1,1
1,1,1,2,2,2,2,2,2,2,1,0,0,0,1,2,2,2,2,2,2,2,1,1,1
1,1,1,1,1,1,1,1,1,1,1,1,1,1,1,1,1,1,1,1,1,1,1,1,1
1,1,1,1,1,1,1,1,1,1,1,1,1,1,1,1,1,1,1,1,1,1,1,1,1
1,1,1,1,1,1,1,1,1,1,1,1,1,1,1,1,1,1,1,1,1,1,1,1,1
1,1,1,1,1,1,1,1,1,1,1,1,1,1,1,1,1,1,1,1,1,1,1,1,1
1,1,1,1,1,1,1,1,1,1,1,1,1,1,1,1,1,1,1,1,1,1,1,1,1