OnettTheme.mp3
25,30
1,1,1,1,1,1,1,1,1,1,1,1,1,1,1,1,1,1,1,1,1,1,1,1,1
1,1,1,1,1,1,1,1,1,1,1,1,1,1,1,1,1,1,1,1,1,1,1,1,1
1,1,0,0,0,0,0,0,0,0,0,0,2,2,2,2,0,1,0,0,0,1,1,1,1
1,1,0,1,0,0,0,0,0,2,1,1,0,0,0,1,1,1,0,1,1,1,1,1,1
1,1,0,1,1,1,0,0,2,0,0,1,0,0,0,1,0,0,0,-1,0,0,0,0,16
1,1,0,0,1,0,0,2,0,0,0,0,0,0,0,1,0,2,0,1,1,1,1,1,1
1,1,0,0,0,0,0,0,0,1,1,1,0,0,0,1,1,0,2,0,0,1,1,1,1
1,1,0,0,0,2,0,1,1,1,0,1,1,1,1,1,1,0,0,0,0,0,1,1,1
1,1,0,2,0,0,1,1,2,4,4,0,0,0,0,0,0,0,0,0,2,0,2,1,1
1,1,0,0,2,0,1,0,2,4,0,0,2,0,2,0,0,0,2,2,0,0,0,1,1
1,1,0,0,0,2,1,1,1,1,0,0,0,0,0,2,0,2,0,0,1,2,2,1,1
1,1,0,-1,0,0,0,0,0,0,-1,0,0,0,0,1,0,0,1,1,2,2,2,1,1
1,1,0,0,0,0,0,0,0,0,0,1,1,1,1,1,1,1,1,1,2,2,2,1,1
1,1,0,0,0,0,0,0,0,0,0,0,2,0,0,1,1,1,0,1,1,2,2,1,1
1,1,0,0,0,0,0,0,0,0,0,2,2,2,1,0,0,0,0,0,1,1,1,1,1
1,1,0,0,0,4,4,0,0,0,2,2,2,2,2,0,0,0,0,0,0,0,0,1,1
1,1,0,0,0,0,0,0,0,0,2,0,0,0,2,0,0,0,0,0,0,0,0,1,1
1,1,0,1,0,0,0,0,0,2,2,2,0,2,2,2,0,0,0,0,0,0,0,1,1
1,1,0,0,1,1,1,0,2,2,2,2,2,2,2,2,2,0,0,0,0,0,0,1,1
1,1,0,0,1,1,1,0,0,0,0,0,0,0,0,0,0,0,0,0,0,0,0,1,1
1,1,0,0,0,1,0,0,0,0,0,0,0,0,0,0,1,1,1,1,0,1,1,1,1
1,1,0,0,0,0,0,0,0,0,0,1,1,1,1,1,1,0,0,1,0,1,0,1,1
1,1,0,0,0,0,0,0,0,0,0,0,1,0,0,0,2,0,2,1,0,1,2,1,1
1,1,0,2,2,2,2,2,2,0,0,0,1,2,0,1,1,1,0,1,0,1,0,1,1
1,1,2,2,2,2,1,1,1,1,1,1,1,1,0,1,1,0,2,1,0,1,2,1,1
1,1,2,2,2,1,1,0,0,0,0,4,0,0,2,1,1,2,0,-1,0,1,0,1,1
1,1,1,1,1,1,0,0,1,1,1,1,1,2,0,1,1,1,1,1,1,1,2,1,1
17,0,0,0,0,0,0,1,1,2,2,2,1,1,1,1,1,0,2,0,0,2,0,1,1
1,1,1,1,1,1,1,1,1,1,1,1,1,1,1,1,1,1,1,1,1,1,1,1,1
1,1,1,1,1,1,1,1,1,1,1,1,1,1,1,1,1,1,1,1,1,1,1,1,1