OnettTheme.mp3
25,30
1,1,1,1,1,1,1,1,1,1,1,1,1,1,1,1,1,1,1,1,1,1,1,1,1
1,1,1,1,1,1,1,1,1,1,1,1,1,1,1,1,1,1,1,1,1,1,1,1,1
1,1,0,0,0,0,0,0,0,0,0,0,2,2,2,2,0,1,0,0,0,1,1,1,1
1,1,0,1,0,0,0,0,0,2,1,1,0,0,0,1,1,1,0,1,1,1,1,1,1
1,1,0,1,1,1,0,0,2,0,0,1,0,0,0,1,0,0,0,-1,0,0,0,0,51
1,1,0,0,1,0,0,2,0,0,0,0,0,0,0,1,0,2,0,1,1,1,1,1,1
1,1,0,0,0,0,0,0,0,1,1,1,0,0,0,1,1,0,2,0,0,1,1,1,1
1,1,0,0,0,2,0,1,1,1,0,1,1,1,1,1,1,0,0,0,0,0,1,1,1
1,1,0,2,0,0,1,1,2,26,26,0,0,0,0,0,0,0,0,0,2,0,2,1,1
1,1,0,0,2,0,1,0,2,26,0,0,2,0,2,0,0,0,2,2,0,0,0,1,1
1,1,0,0,0,2,1,1,1,1,0,0,0,0,0,2,0,2,0,0,1,2,2,1,1
1,1,0,-1,0,0,0,0,0,0,-1,0,0,0,0,1,0,0,1,1,2,2,2,1,1
1,1,0,0,0,0,0,0,0,0,0,1,1,1,1,1,1,1,1,1,2,2,2,1,1
1,1,0,0,0,0,0,0,0,0,0,0,2,0,0,1,1,1,0,1,1,2,2,1,1
1,1,0,0,0,0,0,0,0,0,0,2,2,2,1,0,0,0,0,0,1,1,1,1,1
1,1,0,0,0,26,26,0,0,0,2,2,2,2,2,0,0,0,0,0,0,0,0,1,1
1,1,0,0,0,0,0,0,0,0,2,0,0,0,2,0,0,0,0,0,0,0,0,1,1
1,1,0,1,0,0,0,0,0,2,2,2,0,2,2,2,0,0,0,0,0,0,0,1,1
1,1,0,0,1,1,1,0,2,2,2,2,2,2,2,2,2,0,0,0,0,0,0,1,1
1,1,0,0,1,1,1,0,0,0,0,0,0,0,0,0,0,0,0,0,0,0,0,1,1
1,1,0,0,0,1,0,0,0,0,0,0,0,0,0,0,1,1,1,1,0,1,1,1,1
1,1,0,0,0,0,0,0,0,0,0,1,1,1,1,1,1,0,0,1,0,1,0,1,1
1,1,0,0,0,0,0,0,0,0,0,0,1,0,0,0,2,0,2,1,0,1,2,1,1
1,1,0,2,2,2,2,2,2,0,0,0,1,2,0,1,1,1,0,1,0,1,0,1,1
1,1,2,2,2,2,1,1,1,1,1,1,1,1,0,1,1,0,2,1,0,1,2,1,1
1,1,2,2,2,1,1,0,0,0,0,26,0,0,2,1,1,2,0,-1,0,1,0,1,1
50,0,1,1,1,1,0,0,1,1,1,1,1,2,0,1,1,1,1,1,1,1,2,1,1
1,0,0,0,0,0,0,1,1,2,2,2,1,1,1,1,1,0,2,0,0,2,0,1,1
1,1,1,1,1,1,1,1,1,1,1,1,1,1,1,1,1,1,1,1,1,1,1,1,1
1,1,1,1,1,1,1,1,1,1,1,1,1,1,1,1,1,1,1,1,1,1,1,1,1