OnettTheme.mp3
25,30
11,11,11,11,11,11,11,11,11,11,11,11,11,11,11,11,11,11,11,11,11,11,11,11,11
11,11,11,11,11,11,11,11,11,11,11,11,11,11,11,11,11,11,11,11,11,11,11,11,11
11,11,20,20,20,12,20,20,20,20,11,11,11,20,20,20,20,20,20,20,20,20,20,11,11
11,11,20,12,20,12,20,20,20,20,11,11,11,20,20,20,20,20,20,20,20,14,20,11,11
11,11,12,20,20,20,20,20,12,20,11,11,11,20,20,20,20,-2,20,12,20,20,20,11,11
11,11,20,20,11,11,20,20,20,20,20,20,11,20,20,20,20,20,20,20,20,20,20,11,11
11,11,20,12,11,11,20,12,20,12,20,20,11,20,20,20,20,20,20,20,11,20,20,11,11
11,11,20,20,11,11,20,20,11,11,12,12,11,20,20,20,-2,20,-2,20,20,20,20,11,11
11,11,12,20,11,11,11,11,11,20,20,20,11,20,20,20,20,20,20,20,20,20,20,11,11
11,11,20,20,20,14,20,20,11,20,20,20,11,20,20,11,11,11,11,11,20,11,11,11,11
11,11,20,12,20,20,20,20,11,12,11,11,11,11,20,20,20,12,20,20,20,20,20,11,11
11,11,20,20,20,20,12,20,11,20,20,20,11,11,20,20,20,20,20,20,20,20,20,11,11
11,11,11,11,11,11,11,20,11,20,12,20,11,11,20,20,-2,20,20,20,-2,20,20,11,11
52,20,20,20,20,20,20,20,11,20,20,20,11,20,11,20,11,20,20,20,20,20,20,11,11
11,11,11,11,11,11,11,11,11,20,20,12,11,20,20,11,20,20,20,20,20,20,20,11,11
11,11,12,12,11,12,20,20,20,-2,11,11,11,11,11,11,20,20,11,11,11,11,11,11,11
11,11,11,11,11,12,20,12,12,20,12,20,11,11,11,11,-2,-2,20,20,20,20,20,20,53
11,11,20,20,20,14,27,11,11,11,11,11,11,11,11,12,12,11,11,11,11,11,11,11,11
11,11,20,20,20,20,20,11,20,20,20,20,-2,20,11,12,20,12,12,12,12,12,12,11,11
11,11,20,20,20,11,12,20,20,12,12,20,11,20,11,12,12,12,12,12,20,12,12,11,11
11,11,20,20,20,11,20,12,20,20,11,11,11,20,11,12,20,12,20,12,12,12,12,11,11
11,11,20,20,12,11,12,11,20,20,11,11,11,20,11,12,20,12,12,12,12,20,12,11,11
11,11,11,20,20,11,20,11,20,20,20,20,11,20,11,20,12,12,12,12,12,20,12,11,11
11,11,11,12,20,11,20,20,20,20,12,20,11,20,11,12,20,12,20,20,12,12,20,11,11
11,11,12,20,20,11,20,12,20,20,20,20,11,20,11,12,20,14,12,12,20,12,20,11,11
11,11,20,20,20,20,-2,20,12,20,12,11,11,12,11,20,12,20,12,20,12,12,12,11,11
11,11,20,20,20,11,11,20,20,20,12,11,11,20,11,11,11,11,11,13,11,20,12,11,11
11,11,12,20,12,11,11,12,20,12,20,12,11,20,12,20,20,20,20,12,20,12,12,11,11
11,11,11,11,11,11,11,11,11,11,11,11,11,11,11,11,11,11,11,11,11,11,11,11,11
11,11,11,11,11,11,11,11,11,11,11,11,11,11,11,11,11,11,11,11,11,11,11,11,11
