18,18,,,,,,,,,,,,,,,,
9,9,9,9,9,9,9,9,9,9,9,9,9,9,9,9,9,9
9,0,0,0,0,0,0,1,1,1,1,1,1,0,0,0,0,9
9,0,0,0,0,0,1,2,2,2,2,2,2,1,0,0,0,9
9,0,0,0,0,1,2,2,2,2,2,2,2,2,1,0,0,9
9,0,0,0,1,1,0,2,2,2,2,2,2,2,1,0,0,9
9,0,0,1,0,0,0,0,2,2,2,2,2,1,1,1,0,9
9,0,0,0,1,1,2,2,2,1,1,1,1,1,1,1,0,9
9,0,0,0,0,1,0,3,0,0,1,1,1,1,1,1,0,9
9,0,0,0,0,1,0,3,0,0,1,0,0,1,1,0,0,9
9,0,0,0,0,1,0,0,0,0,0,0,0,1,0,0,0,9
9,0,0,0,0,0,1,0,0,0,0,1,1,1,1,0,0,9
9,0,0,0,0,0,1,1,1,1,1,1,1,1,1,0,0,9
9,0,0,0,0,1,1,1,1,1,1,0,0,1,1,0,0,9
9,0,0,0,1,0,0,1,0,0,1,0,0,1,0,1,0,9
9,0,0,0,0,1,0,0,1,1,1,1,1,0,0,1,0,9
9,0,0,0,0,0,1,1,1,0,0,0,0,1,1,0,0,9
9,0,0,0,0,0,0,0,0,0,0,0,0,0,0,0,0,9
9,9,9,9,9,9,9,9,9,9,9,9,9,9,9,9,9,9
