OnettTheme.mp3
7,11
11,11,11,D2,11,11,11
11,11,0,0,0,11,11
11,4,4,0,4,4,11
11,0,4,4,4,0,11
11,4,0,4,0,4,11
11,0,4,0,4,0,11
11,0,0,0,0,0,11
11,0,11,11,11,0,11
11,0,0,0,0,0,11
11,11,0,0,0,11,11
11,11,11,D,11,11,11