OnettTheme.mp3
16,12
1,1,1,1,1,1,1,1,1,1,1,1,17,1,1,1
1,1,1,1,1,1,1,1,1,1,1,0,0,0,1,1
1,1,1,1,1,1,1,1,1,1,26,26,0,26,26,1
1,1,1,1,1,1,1,1,1,1,0,26,26,26,0,1
1,1,1,1,1,1,1,1,1,1,26,0,26,0,26,1
1,1,1,1,1,1,1,1,1,1,0,26,0,26,0,1
1,1,1,1,1,1,1,1,1,1,0,0,0,0,0,1
1,1,1,1,1,1,1,1,1,1,0,1,1,1,0,1
1,1,1,1,1,1,1,1,1,1,0,0,0,0,0,1
1,1,1,1,1,1,1,1,1,1,1,33,0,0,0,16
1,1,1,1,1,1,1,1,1,1,1,1,1,1,1,1
1,1,1,1,1,1,1,1,1,1,1,1,1,1,1,1